...............
...........WWW.
...........WGW.
...........W,W.
...........W,W.
..WWWWWWWWWW,W.
..W,,,,.,,.,,W.
..W,WWWWWWWWWW.
..W,W..........
.WW,WW.........
.W,,,W.........
.W,P,W.........
.W,,,W.........
.WWWWW.........
...............
