...............
..........WWW..
..........WGW..
..........W,W..
..........W.W..
..........W,W..
.WWWWWWWWWW,W..
.WEEEEE,,,,,W..
.WEWWWWWWWWWW..
.W,W...........
.W,WWWWWWWWWW..
.W,,,EEEE,,,W..
.W,,EEE,,,,,W..
.WWWWWWWWWW,W..
..........W,W..
.........WW,WW.
.........W,,,W.
.........W,P,W.
.........W,,,W.
.........WWWWW.
