...........
.......WWW.
.......WGW.
.......W,W.
.WWWWWWW,W.
.W,,,,,,,W.
.W,,,WWWWW.
.W...W.....
.W,,,W.....
.WU1UWW....
.W,,,SW....
.W,,,,W....
.W,,,,W....
.W,,,,W....
.W,P,,W....
.W,,,,W....
.WWWWWW....
...........
