................
...........WWW..
...........WGW..
...........W,W..
...........W,W..
..WWWWWWWWWW,WW.
..W,,,B.,,B,,.W.
..W,WWWWWWWWWWW.
..W,W...........
.WW,WW.........
.W,,,W.........
.W,P,W.........
.W,,,W.........
.WWWWW.........
...............
