.............
.........WWW.
.........WGW.
.........W,W.
.WWWWWWWWW,W.
.WE,,,,..,,W.
.WEEE,B..,,W.
.WEWWWWWWWWW.
.WEW.........
.W,WWWWWWW...
.W,,...,,W...
.WWWW,WW,W...
...W,B,W,W...
...W,,,W,W...
.WWWWWEW.W...
.W,,,WEW,W...
.W,W,WEW.W...
.W,W,,,W,W...
.W,WWWWW,W...
.W,,,WWW,W...
.WU1UWWW,W...
.W,,,S,,,W...
.W,,,,,,,W...
.W,,,P,,,W...
.W,,,,,,,W...
.WWWWWWWWW...
.............
