.................
..WWW............
..WGW............
..WEW............
..WEW...WWW......
.WW,WWWWW,WWWW...
.W.B,..,,,,EEW...
.WWWWWWWW,WEEW...
........WBW,EW...
........W,W,,WW..
........W,W,,,W..
........W,WU1UWW.
........W,,,,,SW.
........W,,,,,,W.
........W,,,P,,W.
........W,,,,,,W.
........WWWWWWWW.
.................
