............
..WWWWWWWWW.
..W,,EEEEEW.
..W,,,EEE,W.
..W,WWWWWGW.
..W,W...WWW.
..W,W.......
..W,WWW.....
..W,,.W.....
..WWW,W.....
....W,W.....
..WWW,W.....
..W,,,W.....
..W,BBW.....
..W,,,W.....
..W...W.....
..W,,,W.....
..WU1UW.....
..W,,SW.....
..W,,,W.....
..WW,WW.....
...WPW......
...W,W......
...WWW......
............
